30 15
3 7 7 7 7 7 7 7 7 4 3 7 7 7 7 7 7 7 7 4 3 7 7 7 7 7 7 7 7 4
5 9 9 2 9 9 9 9 9 9 2 9 2 9 9 9 9 9 9 9 9 9 9 2 9 9 9 2 9 6
5 9 9 9 9 9 9 9 9 9 9 9 9 9 9 2 9 9 9 9 2 9 9 9 9 2 9 9 9 6
5 9 2 9 9 9 9 2 9 9 9 2 9 9 9 9 9 2 9 9 9 9 2 9 9 9 9 9 9 6
1 9 9 9 9 2 9 9 9 9 9 9 9 2 9 9 9 9 9 9 9 2 9 9 9 9 9 2 9 2
3 9 9 2 9 9 9 9 9 2 9 2 9 9 9 2 9 9 9 9 9 9 9 9 9 9 2 9 9 4
5 9 9 9 2 9 9 9 9 9 9 9 9 2 9 9 2 9 9 9 9 9 2 9 9 2 9 9 9 6
5 9 9 2 9 9 9 2 2 9 9 9 9 9 9 9 2 9 9 9 2 9 9 9 9 9 9 9 9 6
5 9 9 9 9 9 2 9 9 9 9 9 9 2 9 9 9 9 2 9 9 9 2 9 9 9 9 9 9 6
1 9 2 9 9 2 9 9 9 2 9 9 9 9 9 2 9 9 9 2 9 9 9 9 9 9 2 9 9 2
3 9 9 9 9 9 9 9 2 9 9 9 9 2 9 9 9 9 9 9 9 9 9 2 9 2 9 9 9 4
5 9 9 9 2 9 9 9 9 9 2 9 9 9 9 9 9 2 2 9 9 9 9 9 2 9 9 2 9 6
5 9 9 2 9 9 9 2 9 9 9 9 9 9 9 9 9 9 9 9 2 9 9 9 9 2 9 9 9 6
5 9 9 9 9 2 9 9 9 2 9 9 9 9 9 9 9 9 9 9 9 9 2 9 9 9 9 9 9 6
1 8 8 8 8 8 8 8 8 2 1 8 8 8 8 8 8 8 8 2 1 8 8 8 8 8 8 8 8 2
