10 5
3 7 7 7 7 7 7 7 7 4
5 9 9 9 9 9 9 9 9 6
5 9 9 9 9 9 9 9 9 6
5 9 9 9 9 9 9 9 9 6
1 8 8 8 8 8 8 8 8 2
